		.db		#47
		.db		#47
		.db		#47
		.db		#47
		.db		#47
		.db		#47
		.db		#47
		.db		#47
		.db		#47
		.db		#47
		.db		#47
		.db		#47
		.db		#47
		.db		#47
		.db		#47
		.db		#47
		.db		#47
		.db		#47
		.db		#47
		.db		#47
		.db		#45
		.db		#44
		.db		#43
		.db		#44
		.db		#45
		.db		#44
		.db		#43
		.db		#44
		.db		#45
		.db		#44
		.db		#43
		.db		#44
		.db		#45
		.db		#44
		.db		#43
		.db		#44
		.db		#45
		.db		#47
		.db		#47
		.db		#47
		.db		#47
		.db		#47
		.db		#47
		.db		#50
		.db		#49
		.db		#50
		.db		#49
		.db		#50
		.db		#49
		.db		#47
		.db		#50
		.db		#49
		.db		#50
		.db		#49
		.db		#50
		.db		#49
		.db		#47
		.db		#47
		.db		#43
		.db		#44
		.db		#45
		.db		#44
		.db		#43
		.db		#44
		.db		#45
		.db		#44
		.db		#43
		.db		#44
		.db		#45
		.db		#44
		.db		#43
		.db		#44
		.db		#45
		.db		#44
		.db		#43
		.db		#47
		.db		#47
		.db		#44
		.db		#44
		.db		#44
		.db		#44
		.db		#47
		.db		#46
		.db		#46
		.db		#46
		.db		#46
		.db		#47
		.db		#42
		.db		#42
		.db		#42
		.db		#42
		.db		#47
		.db		#44
		.db		#44
		.db		#44
		.db		#44
		.db		#47
		.db		#46
		.db		#46
		.db		#46
		.db		#46
		.db		#47
		.db		#42
		.db		#42
		.db		#42
		.db		#42
		.db		#47
		.db		#47
		.db		#47
		.db		#50
		.db		#49
		.db		#50
		.db		#49
		.db		#50
		.db		#49
		.db		#47
		.db		#47
		.db		#48
		.db		#48
		.db		#48
		.db		#48
		.db		#48
		.db		#48
		.db		#48
		.db		#48
		.db		#47
		.db		#47
		.db		#42
		.db		#43
		.db		#44
		.db		#45
		.db		#46
		.db		#47
		.db		#47
		.db		#47
		.db		#42
		.db		#43
		.db		#44
		.db		#45
		.db		#46
		.db		#47
		.db		#47
		.db		#46
		.db		#45
		.db		#44
		.db		#43
		.db		#42
		.db		#47
		.db		#47
		.db		#47
		.db		#46
		.db		#45
		.db		#44
		.db		#43
		.db		#42
		.db		#47
