		.db		#28
		.db		#28
		.db		#28
		.db		#28
		.db		#28
		.db		#36
		.db		#35
		.db		#34
		.db		#36
		.db		#35
		.db		#34
		.db		#36
		.db		#35
		.db		#34
		.db		#36
		.db		#35
		.db		#34
		.db		#36
		.db		#35
		.db		#34
		.db		#28
		.db		#38
		.db		#38
		.db		#38
		.db		#28
		.db		#38
		.db		#38
		.db		#38
		.db		#28
		.db		#38
		.db		#38
		.db		#38
		.db		#28
		.db		#39
		.db		#39
		.db		#39
		.db		#28
		.db		#39
		.db		#39
		.db		#39
		.db		#28
		.db		#40
		.db		#40
		.db		#40
		.db		#28
		.db		#40
		.db		#40
		.db		#40
		.db		#28
		.db		#41
		.db		#41
		.db		#41
		.db		#28
		.db		#41
		.db		#41
		.db		#41
		.db		#28
		.db		#41
		.db		#41
		.db		#41
		.db		#28
		.db		#40
		.db		#40
		.db		#40
		.db		#28
		.db		#39
		.db		#39
		.db		#39
		.db		#28
		.db		#38
		.db		#38
		.db		#38
		.db		#28
		.db		#38
		.db		#38
		.db		#38
		.db		#28
		.db		#37
		.db		#37
		.db		#37
		.db		#28
		.db		#37
		.db		#37
		.db		#37
		.db		#28
		.db		#37
		.db		#37
		.db		#37
		.db		#28
		.db		#34
		.db		#34
		.db		#34
		.db		#34
		.db		#28
		.db		#35
		.db		#35
		.db		#35
		.db		#35
		.db		#28
		.db		#36
		.db		#36
		.db		#36
		.db		#36
		.db		#28
		.db		#35
		.db		#35
		.db		#35
		.db		#35
		.db		#28
		.db		#34
		.db		#34
		.db		#34
		.db		#34
		.db		#28
		.db		#28
		.db		#28
		.db		#28
		.db		#28
		.db		#28
		.db		#28
		.db		#28
		.db		#28
		.db		#28
		.db		#28
		.db		#28
		.db		#28
		.db		#28
		.db		#28
		.db		#28
		.db		#28
		.db		#28
		.db		#28
		.db		#28
		.db		#33
		.db		#33
		.db		#33
		.db		#33
		.db		#33
		.db		#33
		.db		#32
		.db		#32
		.db		#32
		.db		#32
		.db		#47
		.db		#47
		.db		#47
		.db		#47
		.db		#46
		.db		#47
		.db		#46
		.db		#47
		.db		#42
		.db		#47
		.db		#42
		.db		#47
		.db		#47
