		.db		#1
		.db		#0
		.db		#4
		.db		#7
		.db		#0
		.db		#0
		.db		#0
		.db		#0
		.db		#0
		.db		#26
		.db		#0
		.db		#26
		.db		#0
		.db		#26
		.db		#0
		.db		#26
		.db		#0
		.db		#26
		.db		#0
		.db		#26
		.db		#0
		.db		#21
		.db		#20
		.db		#20
		.db		#20
		.db		#20
		.db		#20
		.db		#19
		.db		#19
		.db		#19
		.db		#19
		.db		#13
		.db		#12
		.db		#11
		.db		#10
		.db		#9
		.db		#27
		.db		#17
		.db		#27
		.db		#17
		.db		#27
		.db		#17
		.db		#27
		.db		#17
		.db		#27
		.db		#17
		.db		#0
		.db		#0
		.db		#0
		.db		#0
		.db		#0
		.db		#25
		.db		#0
		.db		#0
		.db		#26
		.db		#0
		.db		#0
		.db		#0
		.db		#26
		.db		#0
		.db		#0
		.db		#25
		.db		#0
		.db		#11
		.db		#13
		.db		#13
		.db		#13
		.db		#13
		.db		#13
		.db		#21
		.db		#20
		.db		#19
		.db		#18
		.db		#20
		.db		#20
		.db		#0
		.db		#20
		.db		#20
		.db		#18
		.db		#19
		.db		#20
		.db		#21
		.db		#1
		.db		#0
		.db		#4
		.db		#7
		.db		#0
		.db		#5
		.db		#2
		.db		#0
		.db		#6
		.db		#0
		.db		#5
		.db		#0
		.db		#0
		.db		#0
		.db		#0
		.db		#0
		.db		#16
		.db		#16
		.db		#0
		.db		#21
		.db		#20
		.db		#8
		.db		#19
		.db		#18
		.db		#0
		.db		#16
		.db		#16
		.db		#0
		.db		#0
		.db		#16
		.db		#16
		.db		#0
		.db		#21
		.db		#20
		.db		#8
		.db		#19
		.db		#18
		.db		#0
		.db		#16
		.db		#16
		.db		#22
		.db		#22
		.db		#22
		.db		#22
		.db		#0
		.db		#23
		.db		#23
		.db		#23
		.db		#23
		.db		#23
		.db		#23
		.db		#23
		.db		#23
		.db		#24
		.db		#24
		.db		#24
		.db		#24
		.db		#24
		.db		#24
		.db		#24
		.db		#24
		.db		#0
		.db		#25
		.db		#0
		.db		#0
		.db		#26
		.db		#0
		.db		#0
		.db		#0
		.db		#26
		.db		#0
		.db		#0
		.db		#25
		.db		#0
