		.db		#1
		.db		#0
		.db		#4
		.db		#7
		.db		#1
		.db		#7
		.db		#0
		.db		#1
		.db		#0
		.db		#4
		.db		#1
		.db		#0
		.db		#4
		.db		#7
		.db		#0
		.db		#0
		.db		#0
		.db		#25
		.db		#0
		.db		#0
		.db		#26
		.db		#0
		.db		#0
		.db		#0
		.db		#26
		.db		#0
		.db		#0
		.db		#25
		.db		#0
		.db		#0
		.db		#26
		.db		#0
		.db		#0
		.db		#0
		.db		#26
		.db		#0
		.db		#0
		.db		#25
		.db		#0
		.db		#0
		.db		#26
		.db		#0
		.db		#0
		.db		#0
		.db		#26
		.db		#0
		.db		#0
		.db		#25
		.db		#0
		.db		#0
		.db		#22
		.db		#22
		.db		#22
		.db		#22
		.db		#22
		.db		#22
		.db		#22
		.db		#22
		.db		#22
		.db		#22
		.db		#22
		.db		#0
		.db		#22
		.db		#22
		.db		#22
		.db		#22
		.db		#22
		.db		#22
		.db		#22
		.db		#22
		.db		#22
		.db		#22
		.db		#22
		.db		#0
		.db		#15
		.db		#15
		.db		#15
		.db		#15
		.db		#15
		.db		#15
		.db		#15
		.db		#15
		.db		#15
		.db		#15
		.db		#0
		.db		#15
		.db		#15
		.db		#15
		.db		#15
		.db		#15
		.db		#15
		.db		#15
		.db		#15
		.db		#15
		.db		#15
		.db		#0
		.db		#0
		.db		#16
		.db		#16
		.db		#0
		.db		#21
		.db		#20
		.db		#8
		.db		#19
		.db		#18
		.db		#0
		.db		#16
		.db		#16
		.db		#0
		.db		#0
		.db		#16
		.db		#16
		.db		#0
		.db		#21
		.db		#20
		.db		#8
		.db		#19
		.db		#18
		.db		#0
		.db		#16
		.db		#16
		.db		#0
		.db		#0
		.db		#0
		.db		#0
		.db		#0
		.db		#27
		.db		#17
		.db		#27
		.db		#0
		.db		#0
		.db		#0
		.db		#0
		.db		#0
		.db		#0
		.db		#17
		.db		#27
		.db		#17
		.db		#27
		.db		#17
		.db		#27
		.db		#17
		.db		#27
		.db		#17
		.db		#27
		.db		#17
		.db		#27
		.db		#17
		.db		#27
		.db		#17
		.db		#27
		.db		#17
		.db		#10
		.db		#14
		.db		#13
		.db		#8
